12 12 35 12 12 35 12 12 35 12 12 35 12 12
12 13 36 01 13 36 13 13 36 03 13 36 08 12
37 09 09 13 13 13 08 13 13 13 13 13 00 37
12 08 13 13 13 13 13 13 09 01 02 13 13 12
12 13 13 13 13 13 13 13 13 13 02 05 13 12
12 13 13 13 09 05 13 13 13 13 02 03 13 12
12 13 13 01 13 01 13 13 13 03 13 13 13 12
37 13 13 04 05 13 13 13 13 13 13 13 13 37
12 13 13 09 13 13 13 13 13 06 13 05 13 12
12 03 13 13 13 13 13 02 13 13 13 13 13 12
12 13 13 13 13 13 13 13 13 02 03 05 13 12
37 13 11 13 13 02 13 13 13 13 09 13 09 37
12 13 13 03 13 08 07 13 13 13 13 13 13 12
12 13 00 13 09 25 26 13 09 13 08 13 13 12
12 12 12 12 12 27 28 12 12 12 12 12 12 12