12 12 29 12 12 29 12 12 29 12 12 29 12 12
12 13 30 13 13 30 13 13 30 13 13 30 13 12
12 13 13 13 13 13 13 13 13 13 13 13 13 12
12 08 13 13 13 04 13 13 13 01 02 13 13 12
31 13 13 13 13 13 13 13 13 13 13 13 13 31
12 13 13 13 13 13 13 13 13 13 02 03 13 12
12 13 13 13 13 01 13 13 13 13 13 13 13 12
31 13 13 13 13 13 13 13 13 13 13 13 13 31
12 13 13 13 13 13 13 13 13 13 13 13 13 12
12 13 07 13 13 13 13 02 13 13 13 13 13 12
12 13 13 13 13 13 13 13 13 13 13 13 13 12
31 13 13 13 13 06 13 13 13 13 13 13 13 31
12 13 13 13 13 13 13 13 13 13 01 02 13 12
12 13 13 13 09 25 26 13 13 13 13 13 13 12
12 12 12 12 12 27 28 12 12 12 12 12 12 12