12 12 38 12 12 38 12 12 38 12 12 38 12 12
12 13 39 13 13 39 13 13 39 13 13 39 13 12
12 13 13 13 13 13 08 13 13 13 13 13 13 12
40 08 13 13 13 13 13 13 13 01 02 13 13 40
12 13 13 13 13 13 13 13 13 13 13 13 13 12
12 13 13 13 13 13 13 13 13 13 02 03 13 12
12 13 13 13 13 01 13 13 13 13 13 13 13 12
40 13 13 04 05 13 13 13 13 13 13 13 13 40
12 13 13 13 13 13 13 13 13 13 13 13 13 12
12 13 13 13 13 13 13 02 13 13 13 13 13 12
12 13 13 13 13 13 13 13 13 02 03 13 13 12
40 13 13 13 13 02 13 13 13 13 13 13 13 40
12 13 13 13 13 13 13 13 13 13 13 13 13 12
12 13 13 13 09 25 26 13 13 13 13 13 13 12
12 12 12 12 12 27 28 12 12 12 12 12 12 12