12 12 32 12 12 32 12 12 32 12 12 32 12 12
12 13 33 13 13 33 13 13 33 13 13 33 13 12
12 13 13 13 13 13 08 13 13 13 13 13 13 12
34 08 13 13 13 13 13 13 13 01 02 13 13 34
12 13 13 13 13 13 13 13 13 13 13 13 13 12
12 13 13 13 13 13 13 13 13 13 02 03 13 12
12 13 13 13 13 01 13 13 13 13 13 13 13 12
34 13 13 04 05 13 13 13 13 13 13 13 13 34
12 13 13 13 13 13 13 13 13 13 13 13 13 12
12 13 13 13 13 13 13 02 13 13 13 13 13 12
12 13 13 13 13 13 13 13 13 02 03 13 13 12
34 13 13 13 13 02 13 13 13 13 13 13 13 34
12 13 13 13 13 13 13 13 13 13 13 13 13 12
12 13 13 13 09 25 26 13 13 13 13 13 13 12
12 12 12 12 12 27 28 12 12 12 12 12 12 12