12 12 12 12 12 12 12 12 12 12 12 12 12 12 12 12 12 12 12 12 12 12 12 12 12 12 12 12 12 12
12 13 13 13 13 13 13 13 13 13 13 13 13 13 13 13 13 13 13 13 13 13 13 13 13 13 13 13 13 12
12 13 13 13 13 13 13 13 13 13 13 13 13 13 13 13 13 13 13 13 13 13 13 13 13 13 13 13 13 12
12 13 13 13 13 13 13 13 13 13 13 13 13 13 13 13 13 13 13 13 13 13 13 13 13 13 13 13 13 12
12 13 13 13 13 13 13 13 13 41 42 42 42 42 42 42 42 42 42 42 43 13 13 13 13 13 13 13 13 12
12 13 13 13 13 13 13 13 13 13 13 13 13 13 13 13 13 13 13 13 13 13 13 13 13 13 13 13 13 12
12 13 13 13 13 13 44 13 13 13 13 13 13 13 13 13 13 13 13 13 13 13 13 44 13 13 13 13 13 12
12 13 13 13 13 13 45 13 13 13 13 13 13 13 13 13 13 13 13 13 13 13 13 45 13 13 13 13 13 12
12 13 13 13 13 13 45 13 13 13 13 13 13 13 13 13 13 13 13 13 13 13 13 45 13 13 13 13 13 12
12 13 13 13 13 13 45 13 13 13 13 13 13 13 13 13 13 13 13 13 13 13 13 45 13 13 13 13 13 12
12 13 13 13 13 13 45 13 13 13 13 13 13 13 13 13 13 13 13 13 13 13 13 45 13 13 13 13 13 12
12 13 13 13 13 13 45 13 13 13 13 13 13 13 13 13 13 13 13 13 13 13 13 45 13 13 13 13 13 12
12 13 13 13 13 13 45 13 13 13 13 13 13 13 13 13 13 13 13 13 13 13 13 45 13 13 13 13 13 12
12 13 13 13 13 13 45 13 13 13 13 13 13 13 13 13 13 13 13 13 13 13 13 45 13 13 13 13 13 12
12 13 13 13 13 13 45 13 13 13 13 13 13 13 13 13 13 13 13 13 13 13 13 45 13 13 13 13 13 12
12 13 13 13 13 13 46 13 13 13 13 13 13 13 13 13 13 13 13 13 13 13 13 46 13 13 13 13 13 12
12 13 13 13 13 13 13 13 13 13 13 13 13 13 13 13 13 13 13 13 13 13 13 13 13 13 13 13 13 12
12 12 12 12 12 12 12 12 12 12 12 12 12 12 12 12 12 12 12 12 12 12 12 12 12 12 12 12 12 12
