12 12 12 12 12 12 12 12 12 12 12 12 12 12 12 12 12 12 12 12 12 12 12 12 12 12 12 12 12 12 12 12 12 12 12 12 12 12 12 12 12 12 12 12 12 12 12 12 12 12 12 12 12 12 12 12 12 12 12 12 12 12 12 12 12 12 12 12 12 12 12 12 12 12 12
12 13 13 13 13 13 13 13 13 17 13 13 13 13 13 13 13 13 13 9 13 13 4 13 1 13 13 13 13 13 13 13 13 13 13 10 13 13 13 13 13 13 13 13 13 2 13 13 13 13 13 13 13 13 13 13 13 13 13 13 13 13 5 13 13 13 13 13 5 13 13 13 13 11 12
12 13 13 13 13 13 13 13 10 18 13 13 13 13 13 13 6 9 13 13 13 2 13 13 13 13 13 13 13 13 13 13 13 13 13 13 13 13 11 13 7 13 13 13 13 13 13 13 13 13 13 13 10 13 13 13 13 13 13 13 13 10 13 1 13 13 13 13 13 13 13 13 13 13 12
12 13 13 13 13 13 13 0 13 13 13 13 13 13 13 13 13 13 13 13 10 13 13 13 13 5 13 13 13 13 13 13 13 13 13 1 13 13 9 13 13 13 12 13 12 13 13 13 13 13 1 13 13 13 13 13 13 0 1 2 3 13 13 13 13 13 13 13 13 13 13 2 4 13 12
12 13 13 13 1 1 13 13 5 13 13 13 3 13 13 13 13 13 13 13 13 13 13 13 13 13 13 13 3 13 13 13 13 13 13 13 13 13 13 13 13 13 13 13 13 10 13 10 10 8 13 13 12 6 13 13 13 4 5 6 7 13 14 13 13 13 13 13 13 13 13 13 13 13 12
12 13 13 13 10 13 13 12 12 12 12 12 12 12 13 13 13 13 13 13 13 3 13 13 13 13 13 13 1 9 13 13 13 13 13 13 13 13 13 13 13 13 13 13 13 13 13 13 13 13 13 13 13 13 13 9 13 8 9 10 11 13 15 13 13 13 13 13 2 13 13 11 5 13 12
12 13 1 13 13 13 13 12 13 13 13 13 13 12 13 13 12 13 13 13 13 13 13 13 13 13 13 13 13 13 13 13 13 13 13 13 9 13 13 13 13 13 13 13 13 13 12 13 13 13 13 14 1 13 13 13 13 13 13 13 13 13 16 13 13 14 13 13 13 13 13 13 13 8 12
12 13 13 13 13 13 13 12 13 13 13 13 13 12 13 13 13 13 13 13 13 2 13 13 13 13 13 13 13 13 13 13 13 13 13 13 13 11 13 13 4 13 8 0 13 13 13 13 13 13 10 15 13 13 13 13 13 13 0 13 13 13 13 13 13 15 13 13 13 13 13 14 13 13 12
12 13 8 13 13 13 13 12 13 13 13 13 13 12 13 13 13 13 8 13 13 6 13 13 13 13 13 13 13 13 13 13 13 7 13 13 13 13 13 13 13 13 13 13 13 13 13 13 13 13 3 16 13 12 13 13 11 13 13 13 13 13 13 13 13 16 12 7 13 13 13 15 13 13 12
12 13 13 13 13 13 13 12 13 13 13 5 13 12 13 13 13 13 13 12 13 13 13 13 13 13 13 13 13 1 13 13 13 13 13 13 13 13 13 13 14 13 13 13 13 13 13 11 13 13 13 13 13 13 13 13 13 13 13 13 13 13 13 13 6 13 13 13 13 13 13 16 13 13 12
12 13 13 13 13 13 13 12 13 13 13 13 13 12 13 13 13 12 13 13 13 13 9 13 13 7 13 13 13 13 13 13 13 13 13 13 13 13 13 13 15 13 8 13 8 13 5 12 13 13 8 6 0 13 13 13 13 13 13 13 13 12 13 13 13 13 13 13 13 13 13 13 13 13 12
12 13 13 13 2 1 2 12 12 12 13 12 12 12 13 13 13 13 13 3 13 13 13 13 13 13 13 13 5 13 13 13 13 13 13 13 13 13 13 13 16 13 13 13 13 13 6 13 13 13 13 13 13 13 13 14 13 13 13 13 13 13 13 13 13 13 13 13 13 13 13 13 13 13 12
12 13 13 13 4 5 6 7 13 13 13 13 13 13 13 13 13 13 13 13 13 13 13 13 13 13 13 13 13 13 13 13 13 13 13 13 13 13 13 13 1 2 3 13 13 13 2 13 13 13 13 13 13 13 5 15 0 1 2 3 13 10 13 13 13 13 13 5 13 13 13 13 13 13 12
12 13 13 13 8 9 10 11 13 13 2 13 13 13 13 13 13 13 13 13 13 13 13 13 13 5 7 13 12 13 9 13 13 13 13 13 13 13 7 4 5 6 7 13 13 13 13 0 13 13 13 13 6 13 13 16 4 5 6 7 13 13 12 13 13 13 13 13 13 13 13 13 13 2 12
12 13 13 13 13 13 13 9 12 13 13 13 13 6 13 13 13 13 13 13 13 13 13 13 1 13 13 13 13 13 1 2 3 13 13 13 13 13 13 8 9 10 11 13 13 13 5 13 13 13 13 8 13 13 13 13 8 9 10 11 0 13 13 13 13 14 13 13 13 13 13 13 13 13 12
12 13 13 13 13 13 13 13 11 13 13 13 9 13 13 13 13 13 13 13 13 13 14 13 13 13 13 13 13 4 5 6 7 13 13 13 13 13 13 13 13 13 13 13 13 13 13 13 13 13 13 13 13 13 13 13 13 13 13 13 4 13 13 2 13 15 13 13 13 13 13 13 13 13 12
12 13 13 13 4 13 13 13 13 13 13 13 13 13 13 13 13 13 13 0 13 13 15 13 13 13 13 13 13 8 9 10 11 1 13 13 13 13 13 13 13 13 9 13 13 13 13 12 12 13 13 13 13 13 13 0 13 13 13 13 1 13 13 13 13 16 13 13 13 13 13 13 13 13 12
12 13 13 13 13 13 13 13 13 13 13 13 10 13 13 13 0 13 13 13 13 13 16 13 13 13 13 13 8 13 13 13 13 0 13 13 13 13 13 13 13 13 13 12 13 13 13 13 13 13 13 13 6 13 13 13 13 9 13 13 13 13 13 13 13 13 13 13 13 13 13 13 13 3 12
12 13 13 13 13 9 13 13 13 13 13 13 13 13 13 13 8 13 13 13 13 11 0 13 13 13 13 1 13 13 13 0 13 13 13 7 13 13 13 13 13 13 13 13 13 13 2 13 13 13 13 13 13 13 13 13 13 13 13 13 12 13 13 13 13 13 13 13 13 13 13 13 13 13 12
12 13 13 13 13 13 1 13 13 13 13 13 13 13 13 13 13 13 13 13 9 13 13 13 13 13 13 10 13 13 13 13 13 13 13 13 13 13 13 13 14 13 13 13 13 13 13 13 13 13 13 13 13 13 13 13 4 13 13 13 13 13 13 13 13 13 13 13 13 13 1 13 13 13 12
12 13 13 13 13 13 13 13 13 13 13 13 13 13 12 13 13 13 13 13 13 13 13 13 13 17 13 13 13 13 13 13 13 13 13 13 13 13 13 13 15 13 13 13 13 13 13 5 13 13 13 13 13 13 13 13 13 13 13 13 9 13 13 13 13 13 13 13 13 13 13 13 13 13 12
12 13 13 13 13 13 13 13 6 13 13 0 13 13 13 13 13 3 13 13 13 13 13 1 13 18 8 13 13 13 13 13 10 13 13 13 0 13 13 9 16 13 13 13 13 13 13 13 13 13 9 13 1 13 1 6 13 13 13 13 13 13 13 13 13 13 13 13 13 13 13 13 5 13 12
12 13 13 12 13 8 13 1 13 13 13 13 13 13 13 13 13 13 13 13 13 13 13 13 13 13 13 13 13 13 13 13 13 13 13 13 13 13 13 13 13 13 13 2 13 13 13 13 13 13 13 13 13 13 13 13 13 13 13 13 13 13 13 13 13 13 7 13 13 13 13 13 13 13 12
12 13 13 13 13 11 13 13 13 13 13 11 13 13 13 13 13 13 13 13 13 13 13 13 13 13 13 13 13 13 2 13 9 13 13 13 13 13 13 14 13 2 13 13 13 13 3 13 13 13 13 13 13 13 13 13 13 8 13 13 13 13 13 10 13 13 13 13 13 13 13 13 13 13 12
12 13 13 13 13 12 13 13 13 13 13 13 13 3 8 13 13 13 13 13 13 13 13 13 13 13 13 13 10 13 13 13 13 4 13 13 13 13 12 15 13 13 13 13 13 13 13 13 13 13 13 13 13 10 13 13 3 13 4 13 11 13 13 13 13 13 13 13 13 9 13 13 13 13 12
12 13 13 13 13 13 13 13 0 13 13 13 13 13 13 13 13 13 13 13 13 13 17 13 13 13 13 13 13 13 10 13 13 13 13 13 13 2 13 16 13 17 13 13 13 13 13 13 13 13 13 13 13 12 13 13 1 1 1 13 13 13 13 13 13 13 13 13 6 13 13 13 13 13 12
12 13 13 13 13 13 13 13 9 13 13 13 13 13 13 13 13 13 13 13 13 7 18 13 13 13 13 13 13 13 13 13 13 14 13 13 13 13 13 13 13 18 13 13 13 13 13 13 13 13 13 12 13 13 13 13 1 2 3 11 2 13 13 12 13 13 13 13 4 13 13 13 13 13 12
12 13 9 13 13 13 13 13 13 13 13 13 13 13 13 13 13 2 8 13 13 13 0 13 13 13 13 13 13 13 13 13 0 15 10 13 13 13 13 13 13 10 13 12 13 13 13 13 13 13 13 13 13 13 13 4 5 6 7 13 13 13 13 13 13 13 13 13 13 13 13 13 13 13 12
12 13 13 13 13 12 13 14 13 13 13 13 13 13 1 13 13 13 13 13 13 13 13 13 5 13 13 13 13 13 13 13 13 16 13 13 13 13 13 13 13 13 13 13 13 13 13 13 13 13 13 7 13 13 13 8 9 10 11 13 13 13 13 13 13 13 13 13 0 1 2 3 9 1 12
12 13 13 13 13 13 13 15 13 13 3 13 13 9 13 13 13 13 13 13 13 13 13 13 4 13 13 13 13 13 13 13 4 13 13 13 13 13 13 12 13 13 13 13 13 0 1 2 3 13 13 13 13 13 5 8 13 13 13 12 13 13 13 4 13 13 13 13 4 5 6 7 13 13 12
12 13 13 13 2 13 13 16 11 2 13 13 14 13 13 13 13 13 13 13 13 13 13 13 13 13 13 13 13 13 13 13 13 13 13 13 13 13 13 13 13 13 13 8 13 4 5 6 7 13 13 13 13 13 13 13 13 0 13 13 12 13 13 13 13 13 13 13 8 9 10 11 13 13 12
12 13 13 13 13 13 5 13 13 13 13 13 15 13 13 13 13 13 13 13 13 13 13 13 13 13 13 13 13 13 13 13 13 1 2 3 13 3 9 13 13 13 13 13 13 8 9 10 11 13 13 13 13 13 13 13 0 1 2 3 13 13 13 13 13 13 13 13 13 13 13 13 13 13 12
12 13 10 13 13 13 13 13 13 13 13 13 16 13 13 13 13 5 13 13 13 13 13 13 17 13 13 13 13 13 13 13 4 5 6 7 13 13 13 13 3 13 13 13 13 13 13 13 13 11 13 13 13 0 10 13 4 5 6 7 13 13 13 13 13 13 12 13 13 13 13 11 13 13 12
12 13 13 13 13 13 4 13 13 13 13 13 13 13 13 13 13 13 13 13 13 13 13 13 18 13 17 13 13 12 13 13 8 9 10 11 13 11 13 0 13 13 13 13 13 13 13 13 13 0 13 13 13 13 13 13 8 9 10 11 13 13 3 12 13 6 13 13 13 13 0 13 13 13 12
12 13 7 13 13 11 13 13 13 13 3 13 5 13 13 13 13 13 13 10 13 13 13 13 8 13 18 13 13 13 13 13 13 13 13 13 13 13 13 14 10 13 13 13 13 13 13 13 13 13 0 1 2 3 3 13 13 13 13 13 13 13 13 13 13 13 13 13 13 13 13 13 13 13 12
12 13 13 13 13 13 4 13 13 13 12 13 13 13 14 13 13 13 13 13 13 13 13 13 10 13 3 13 13 13 13 13 13 13 13 1 13 13 13 15 11 13 12 13 13 13 13 13 13 13 4 5 6 7 6 13 13 13 13 13 7 13 13 13 13 13 13 13 13 13 13 2 13 13 12
12 13 13 13 13 13 13 13 13 13 13 13 13 13 15 13 13 13 13 1 2 3 13 13 13 13 13 6 2 13 13 13 13 13 13 13 13 13 13 16 10 13 13 12 13 13 13 3 13 13 8 9 10 11 13 13 13 13 13 13 13 13 13 13 13 13 13 13 13 13 13 13 13 13 12
12 13 13 13 13 13 13 13 6 13 13 13 13 13 16 13 13 13 4 5 6 7 13 13 13 13 0 1 2 3 13 13 11 13 13 13 13 13 13 13 13 13 12 13 13 13 13 13 7 13 13 13 13 13 13 13 13 13 13 13 13 13 13 13 12 13 13 13 12 13 13 13 13 13 12
12 13 13 13 13 10 13 13 13 13 13 13 13 13 8 13 13 13 8 9 10 11 13 13 13 13 4 5 6 7 13 13 13 13 13 13 13 13 13 13 13 13 13 13 13 13 13 13 13 13 13 13 13 13 13 13 8 13 13 13 13 13 13 3 13 6 13 13 13 13 6 13 11 10 12
12 13 13 13 13 13 13 13 13 13 13 13 13 13 13 13 13 7 13 13 13 13 13 13 13 9 8 9 10 11 13 13 13 13 13 13 13 1 13 13 13 13 13 13 13 13 13 13 13 13 13 13 13 13 13 13 13 13 13 13 13 13 13 13 13 13 13 13 13 13 13 13 13 13 12
12 6 13 6 13 13 1 2 3 13 13 13 13 14 1 13 13 13 13 13 13 13 13 13 13 13 13 13 13 13 13 13 13 6 13 13 13 13 13 13 13 13 13 13 13 13 13 13 3 13 9 11 13 13 13 13 13 13 12 12 7 17 13 13 13 13 13 13 13 13 13 13 13 13 12
12 13 13 7 6 4 5 6 7 13 5 13 2 15 13 10 13 0 13 13 13 13 13 13 13 13 13 13 13 13 12 13 13 13 13 13 13 14 13 13 13 13 13 13 13 13 13 13 13 3 13 13 14 1 7 13 13 4 13 13 5 18 13 13 13 7 13 13 13 13 13 13 13 13 12
12 13 13 13 10 8 9 10 11 13 13 13 13 16 13 13 13 13 13 13 13 13 13 13 13 10 13 13 13 13 13 13 13 13 13 13 13 15 13 13 13 13 13 13 13 13 13 13 13 13 13 13 15 13 13 13 13 13 13 13 13 13 13 7 13 13 13 13 13 13 13 13 13 13 12
12 13 13 13 13 13 13 12 13 13 13 17 13 13 13 13 12 5 13 13 13 13 13 13 13 13 13 13 13 13 13 12 13 13 0 13 13 16 13 13 3 13 13 13 13 13 0 13 13 13 13 13 16 13 13 13 13 13 13 13 13 13 13 13 13 17 13 13 12 13 13 13 17 13 12
12 13 13 13 13 1 13 13 13 13 3 18 13 13 6 13 3 13 13 13 13 13 10 13 13 13 13 13 13 13 13 13 13 13 13 13 13 1 2 3 13 8 13 13 13 13 13 5 13 13 13 13 13 13 13 13 12 13 6 13 3 13 13 13 13 18 13 13 10 13 2 13 18 13 12
12 13 13 13 13 13 9 13 13 13 13 13 13 13 13 13 7 13 13 13 13 13 13 13 10 7 13 13 13 0 1 2 3 13 13 13 4 5 6 7 13 13 13 13 13 8 13 13 13 13 13 13 13 13 13 13 13 13 13 13 13 13 13 13 13 13 13 13 13 13 13 13 13 13 12
12 13 7 13 13 13 13 13 13 13 13 13 13 13 13 9 13 13 13 13 13 13 13 13 13 13 13 13 13 4 5 6 7 13 3 13 8 9 10 11 13 13 3 13 13 13 13 13 13 13 13 13 13 13 13 13 13 13 13 0 13 13 13 13 13 13 13 13 13 13 13 13 13 13 12
12 13 13 13 13 13 13 13 13 13 13 13 13 13 13 13 13 13 13 13 13 13 13 12 13 13 13 13 13 8 9 10 11 13 13 13 13 13 7 13 11 5 13 13 13 13 13 13 13 13 13 13 13 3 13 13 6 13 13 13 13 13 13 13 13 13 13 13 13 13 13 13 13 13 12
12 13 3 13 13 13 13 13 13 13 13 13 13 13 13 13 13 13 13 13 13 13 13 13 13 13 13 13 13 13 13 13 13 13 13 13 13 13 13 13 13 5 13 13 13 13 4 13 13 13 13 13 13 13 0 1 2 3 13 13 13 13 13 13 13 13 13 13 13 12 13 13 13 13 12
12 17 13 13 13 13 13 13 13 13 13 13 13 13 9 13 13 8 14 13 12 13 13 13 13 13 13 10 13 13 13 13 10 13 13 13 13 3 13 13 13 13 13 13 13 13 13 13 13 13 13 13 13 3 4 5 6 7 13 13 13 13 13 13 13 13 13 13 13 13 13 13 13 13 12
12 18 13 17 13 13 13 13 13 13 13 13 4 13 13 13 13 13 15 13 13 13 13 13 13 13 13 13 13 13 13 13 13 13 13 13 13 13 13 13 13 13 13 13 13 13 13 13 12 13 10 13 13 13 8 9 10 11 13 13 13 13 13 9 13 13 13 13 13 13 13 0 13 13 12
12 13 6 18 13 13 13 13 13 13 13 13 13 13 13 13 13 13 16 13 13 13 13 13 3 1 13 13 13 13 13 13 13 13 13 13 13 13 13 13 13 13 13 13 13 13 13 13 13 13 13 13 13 13 13 0 13 13 6 13 13 13 13 13 13 13 13 12 13 13 13 13 13 13 12
12 2 13 13 13 13 13 13 13 9 13 13 9 13 13 13 13 13 13 11 13 13 13 13 13 13 13 13 13 13 13 13 13 13 13 13 13 13 13 13 13 13 13 13 13 13 13 13 13 13 2 10 1 2 3 13 13 8 12 13 9 13 13 13 13 13 13 13 6 13 13 13 13 13 12
12 13 13 13 13 13 13 13 13 11 14 12 13 1 13 13 13 13 13 13 14 13 13 13 13 13 13 6 13 10 0 13 13 13 13 13 13 13 13 13 13 13 13 13 13 13 11 13 12 9 0 4 5 6 7 13 13 13 4 12 13 13 13 13 13 13 13 3 13 13 13 13 13 13 12
12 13 13 10 13 13 1 13 13 13 15 13 13 13 3 13 13 13 13 13 15 11 13 13 13 13 13 13 12 13 13 13 13 13 13 13 13 13 13 13 13 13 13 13 13 13 13 13 13 13 13 8 9 10 11 13 13 13 13 13 13 13 13 13 13 13 13 13 13 13 13 13 13 13 12
12 13 13 13 13 13 13 6 13 13 16 13 13 13 13 13 13 13 13 13 16 13 13 13 13 13 13 2 13 13 2 13 13 13 13 13 13 13 13 13 13 13 13 13 7 13 13 13 13 13 13 8 13 13 13 13 13 0 13 13 13 13 13 13 2 12 13 13 13 13 13 13 13 13 12
12 13 13 13 13 4 13 13 13 13 13 13 13 13 13 11 13 13 13 13 13 9 13 13 7 10 13 13 13 13 13 13 13 13 7 13 13 13 13 13 13 13 13 13 13 13 1 13 13 13 13 13 13 13 13 1 13 13 13 13 13 8 13 13 13 13 13 13 4 3 13 13 12 13 12
12 13 13 13 13 8 13 13 13 13 13 13 13 13 13 13 13 13 13 13 13 13 1 13 13 8 13 13 13 13 13 13 3 13 13 13 13 13 13 13 13 13 13 13 13 4 13 13 13 13 13 13 13 13 13 13 9 13 13 13 13 13 13 13 13 13 13 13 13 13 13 13 13 13 12
12 13 13 13 13 13 13 13 14 13 13 2 13 13 13 13 13 13 13 6 13 13 13 11 13 13 12 13 12 13 13 13 13 13 10 13 13 13 13 13 0 13 13 13 13 13 13 13 13 13 13 13 13 2 13 12 13 13 13 3 13 13 13 13 13 13 13 13 13 13 13 13 13 13 12
12 4 13 1 13 13 13 13 15 13 13 13 13 13 13 13 13 13 13 13 13 13 13 13 13 13 13 13 14 13 13 13 4 13 13 13 3 13 13 13 13 13 13 13 13 13 6 13 13 13 13 13 13 14 13 13 13 13 13 10 13 13 11 13 13 13 13 13 13 13 10 13 13 13 12
12 13 13 13 13 13 8 13 16 13 13 1 13 13 8 13 13 13 13 13 13 13 13 13 0 13 1 13 15 13 2 13 13 13 13 13 0 1 2 3 13 13 14 13 13 13 13 13 13 13 13 13 13 15 13 13 13 13 13 0 13 13 13 13 13 13 13 13 13 13 11 13 13 13 12
12 13 13 13 13 13 6 13 13 13 13 13 13 13 13 13 13 13 17 14 13 13 13 13 13 13 13 13 16 13 13 13 13 13 13 13 4 5 6 7 0 13 15 13 13 13 13 13 13 13 1 7 13 16 13 13 13 13 13 13 13 13 13 3 13 13 13 13 13 13 4 14 13 13 12
12 10 1 13 13 13 13 9 13 13 13 13 13 13 13 13 13 13 18 15 13 13 13 13 17 13 13 13 13 13 13 13 13 13 13 13 8 9 10 11 13 13 16 13 13 13 13 13 13 13 2 0 1 2 3 13 13 13 13 13 13 13 13 13 13 13 13 13 13 13 13 15 13 13 12
12 13 13 13 13 12 13 13 13 13 13 13 13 13 13 13 13 13 13 16 13 13 13 13 18 13 13 13 13 6 13 13 13 13 13 13 13 4 13 13 13 13 13 13 13 13 13 9 13 13 10 4 5 6 7 13 13 13 13 13 13 13 13 13 13 13 13 6 13 13 13 16 13 13 12
12 13 13 13 5 13 13 13 13 13 13 13 13 13 13 13 13 13 13 13 13 13 12 13 13 13 13 13 13 14 13 13 13 13 13 13 13 13 6 14 13 13 13 13 13 13 13 13 6 13 13 8 9 10 11 13 13 13 13 13 13 13 13 13 13 13 13 14 13 13 5 13 6 13 12
12 13 13 13 9 13 12 13 13 0 13 0 1 2 3 0 13 13 13 13 13 13 13 13 13 13 13 13 13 15 13 13 13 13 13 13 13 13 13 15 13 13 13 13 13 13 9 13 13 13 9 13 13 13 13 13 13 13 13 13 13 13 13 13 12 13 13 15 13 13 13 13 13 13 12
12 13 13 6 13 13 13 13 13 13 8 4 5 6 7 13 13 13 13 13 13 12 13 13 13 13 3 1 13 16 13 13 11 13 13 13 13 13 13 16 6 13 13 13 13 13 12 13 13 13 13 13 13 13 13 12 13 13 13 13 13 13 13 13 13 13 13 16 13 13 13 13 13 13 12
12 13 13 13 13 13 13 13 13 13 13 8 9 10 11 13 13 12 13 13 11 2 13 13 13 13 13 13 13 13 13 13 13 13 13 13 0 1 2 3 13 13 13 13 13 6 13 13 13 13 13 6 13 13 13 13 13 13 13 13 13 13 13 13 13 13 13 10 0 8 13 13 13 13 12
12 13 13 5 13 13 13 13 13 13 13 13 13 13 13 13 13 13 13 13 13 13 13 13 13 13 7 13 7 13 11 8 13 13 13 9 4 5 6 7 13 13 13 13 13 13 1 2 3 13 13 13 13 7 13 12 13 12 13 13 13 13 6 13 13 13 13 13 13 0 13 13 13 13 12
12 13 13 13 13 13 13 13 13 13 9 13 13 13 13 0 13 10 13 13 4 13 10 13 13 13 13 13 2 13 8 13 13 13 13 13 8 9 10 11 13 13 13 13 13 4 5 6 7 11 13 13 13 13 13 13 13 13 13 13 13 13 13 13 13 13 13 13 13 3 13 13 13 13 12
12 13 13 13 13 13 13 13 8 9 13 13 13 13 12 13 13 13 4 13 13 6 13 13 13 13 13 13 13 13 13 13 13 13 13 13 13 13 13 13 13 13 13 13 13 8 9 10 11 13 13 17 13 13 13 13 13 13 13 13 13 13 13 13 13 13 13 13 13 13 13 13 13 13 12
12 13 13 13 2 13 13 13 13 13 13 13 13 12 13 13 13 1 13 13 13 13 13 13 13 13 13 13 13 13 13 13 13 13 13 13 13 13 13 13 13 13 13 13 7 13 13 7 13 13 13 18 13 13 13 13 4 13 13 13 13 13 13 13 13 13 13 13 13 13 5 13 13 6 12
12 10 13 13 13 13 13 13 13 13 13 13 13 13 13 13 13 13 13 13 13 13 13 13 3 13 13 13 13 13 13 13 13 13 13 13 13 13 13 13 13 13 13 13 13 13 13 5 13 13 13 13 13 13 13 13 13 13 13 13 13 6 13 13 13 13 13 2 13 13 10 13 13 13 12
12 13 13 13 13 5 13 13 13 13 13 13 13 7 13 13 13 1 13 13 13 13 13 13 13 13 13 13 0 13 9 13 13 13 13 13 13 13 8 13 13 13 13 13 13 13 13 13 13 13 5 1 13 13 13 13 13 13 12 13 11 13 13 13 13 13 13 13 13 6 13 13 13 13 12
12 12 12 12 12 12 12 12 12 12 12 12 12 12 12 12 12 12 12 12 12 12 12 12 12 12 12 12 12 12 12 12 12 12 12 12 12 12 12 12 12 12 12 12 12 12 12 12 12 12 12 12 12 12 12 12 12 12 12 12 12 12 12 12 12 12 12 12 12 12 12 12 12 12 12
